"filename", "language", "C++", "comment", "blank", "total"
"q:\Projects\Arduino Projects\Mobo\Code\Firmware\Mobo\src\BatterySystem.h", "C++", 51, 0, 17, 68
"q:\Projects\Arduino Projects\Mobo\Code\Firmware\Mobo\src\Component.h", "C++", 16, 0, 4, 20
"q:\Projects\Arduino Projects\Mobo\Code\Firmware\Mobo\src\Config\Config.h", "C++", 0, 0, 3, 3
"q:\Projects\Arduino Projects\Mobo\Code\Firmware\Mobo\src\Driver\MotorDriver.h", "C++", 16, 0, 10, 26
"q:\Projects\Arduino Projects\Mobo\Code\Firmware\Mobo\src\Driver\RN_VNH2.cpp", "C++", 62, 0, 16, 78
"q:\Projects\Arduino Projects\Mobo\Code\Firmware\Mobo\src\Driver\RN_VNH2.h", "C++", 22, 0, 15, 37
"q:\Projects\Arduino Projects\Mobo\Code\Firmware\Mobo\src\Driver\bts7960.cpp", "C++", 60, 0, 16, 76
"q:\Projects\Arduino Projects\Mobo\Code\Firmware\Mobo\src\Driver\bts7960.h", "C++", 25, 0, 9, 34
"q:\Projects\Arduino Projects\Mobo\Code\Firmware\Mobo\src\Motor.cpp", "C++", 55, 0, 18, 73
"q:\Projects\Arduino Projects\Mobo\Code\Firmware\Mobo\src\Motor.h", "C++", 27, 0, 11, 38
"q:\Projects\Arduino Projects\Mobo\Code\Firmware\Mobo\src\MovementSystem.h", "C++", 13, 0, 8, 21
"q:\Projects\Arduino Projects\Mobo\Code\Firmware\Mobo\src\MovementSystemTimeBased.cpp", "C++", 235, 0, 52, 287
"q:\Projects\Arduino Projects\Mobo\Code\Firmware\Mobo\src\MovementSystemTimeBased.h", "C++", 44, 0, 21, 65
"q:\Projects\Arduino Projects\Mobo\Code\Firmware\Mobo\src\ObjectDetectionSystem.h", "C++", 100, 0, 34, 134
"q:\Projects\Arduino Projects\Mobo\Code\Firmware\Mobo\src\Robot.cpp", "C++", 38, 0, 15, 53
"q:\Projects\Arduino Projects\Mobo\Code\Firmware\Mobo\src\Robot.h", "C++", 37, 0, 9, 46
"q:\Projects\Arduino Projects\Mobo\Code\Firmware\Mobo\src\Sensor\AnalogSensor\AnalogSensor.h", "C++", 8, 0, 3, 11
"q:\Projects\Arduino Projects\Mobo\Code\Firmware\Mobo\src\Sensor\AnalogSensor\SimpleAnalogPin.cpp", "C++", 13, 0, 4, 17
"q:\Projects\Arduino Projects\Mobo\Code\Firmware\Mobo\src\Sensor\AnalogSensor\SimpleAnalogPin.h", "C++", 13, 0, 3, 16
"q:\Projects\Arduino Projects\Mobo\Code\Firmware\Mobo\src\Sensor\Boundary\BoundarySensor.h", "C++", 12, 1, 3, 16
"q:\Projects\Arduino Projects\Mobo\Code\Firmware\Mobo\src\Sensor\Boundary\WireSensor.cpp", "C++", 33, 0, 12, 45
"q:\Projects\Arduino Projects\Mobo\Code\Firmware\Mobo\src\Sensor\Boundary\WireSensor.h", "C++", 17, 0, 7, 24
"q:\Projects\Arduino Projects\Mobo\Code\Firmware\Mobo\src\Sensor\Current\CurrentSensor.h", "C++", 10, 0, 4, 14
"q:\Projects\Arduino Projects\Mobo\Code\Firmware\Mobo\src\Sensor\Current\StandardCurrentSensor.cpp", "C++", 21, 0, 5, 26
"q:\Projects\Arduino Projects\Mobo\Code\Firmware\Mobo\src\Sensor\Current\StandardCurrentSensor.h", "C++", 18, 0, 8, 26
"q:\Projects\Arduino Projects\Mobo\Code\Firmware\Mobo\src\Sensor\DigitalSensor\AnalogToDigital.cpp", "C++", 13, 0, 4, 17
"q:\Projects\Arduino Projects\Mobo\Code\Firmware\Mobo\src\Sensor\DigitalSensor\AnalogToDigital.h", "C++", 16, 0, 4, 20
"q:\Projects\Arduino Projects\Mobo\Code\Firmware\Mobo\src\Sensor\DigitalSensor\DigitalPin.cpp", "C++", 12, 0, 4, 16
"q:\Projects\Arduino Projects\Mobo\Code\Firmware\Mobo\src\Sensor\DigitalSensor\DigitalPin.h", "C++", 13, 0, 5, 18
"q:\Projects\Arduino Projects\Mobo\Code\Firmware\Mobo\src\Sensor\DigitalSensor\DigitalSensor.h", "C++", 8, 0, 3, 11
"q:\Projects\Arduino Projects\Mobo\Code\Firmware\Mobo\src\Sensor\Distance\DistanceSensor.h", "C++", 9, 0, 5, 14
"q:\Projects\Arduino Projects\Mobo\Code\Firmware\Mobo\src\Sensor\Distance\HC_SR04.cpp", "C++", 30, 0, 10, 40
"q:\Projects\Arduino Projects\Mobo\Code\Firmware\Mobo\src\Sensor\Distance\HC_SR04.h", "C++", 18, 0, 8, 26
"q:\Projects\Arduino Projects\Mobo\Code\Firmware\Mobo\src\Sensor\IMU\Accelerometer\ADXL345.cpp", "C++", 116, 0, 47, 163
"q:\Projects\Arduino Projects\Mobo\Code\Firmware\Mobo\src\Sensor\IMU\Accelerometer\ADXL345.h", "C++", 89, 0, 15, 104
"q:\Projects\Arduino Projects\Mobo\Code\Firmware\Mobo\src\Sensor\IMU\Accelerometer\Accelerometer.h", "C++", 13, 1, 4, 18
"q:\Projects\Arduino Projects\Mobo\Code\Firmware\Mobo\src\Sensor\IMU\Compass\Compass.h", "C++", 10, 1, 3, 14
"q:\Projects\Arduino Projects\Mobo\Code\Firmware\Mobo\src\Sensor\IMU\Compass\HMC5883L.cpp", "C++", 137, 0, 49, 186
"q:\Projects\Arduino Projects\Mobo\Code\Firmware\Mobo\src\Sensor\IMU\Compass\HMC5883L.h", "C++", 71, 0, 15, 86
"q:\Projects\Arduino Projects\Mobo\Code\Firmware\Mobo\src\Sensor\IMU\GY80.cpp", "C++", 46, 0, 18, 64
"q:\Projects\Arduino Projects\Mobo\Code\Firmware\Mobo\src\Sensor\IMU\GY80.h", "C++", 35, 0, 14, 49
"q:\Projects\Arduino Projects\Mobo\Code\Firmware\Mobo\src\Sensor\IMU\Gyro\Gyro.h", "C++", 11, 0, 8, 19
"q:\Projects\Arduino Projects\Mobo\Code\Firmware\Mobo\src\Sensor\IMU\Gyro\L3G4200D.cpp", "C++", 144, 2, 58, 204
"q:\Projects\Arduino Projects\Mobo\Code\Firmware\Mobo\src\Sensor\IMU\Gyro\L3G4200D.h", "C++", 89, 0, 32, 121
"q:\Projects\Arduino Projects\Mobo\Code\Firmware\Mobo\src\Sensor\IMU\IMU.h", "C++", 13, 0, 11, 24
"q:\Projects\Arduino Projects\Mobo\Code\Firmware\Mobo\src\Sensor\Voltage\StandardVoltageSensor.cpp", "C++", 19, 0, 5, 24
"q:\Projects\Arduino Projects\Mobo\Code\Firmware\Mobo\src\Sensor\Voltage\StandardVoltageSensor.h", "C++", 16, 0, 6, 22
"q:\Projects\Arduino Projects\Mobo\Code\Firmware\Mobo\src\Sensor\Voltage\VoltageSensor.h", "C++", 9, 0, 2, 11
"q:\Projects\Arduino Projects\Mobo\Code\Firmware\Mobo\src\SetupMoboOne.h", "C++", 119, 8, 65, 192
"q:\Projects\Arduino Projects\Mobo\Code\Firmware\Mobo\src\SetupMoboTwo.h", "C++", 1, 0, 0, 1
"q:\Projects\Arduino Projects\Mobo\Code\Firmware\Mobo\src\States\BootingState.cpp", "C++", 46, 1, 22, 69
"q:\Projects\Arduino Projects\Mobo\Code\Firmware\Mobo\src\States\BootingState.h", "C++", 16, 0, 5, 21
"Total", "-", 2065, 14, 729, 2808