"filename", "language", "C++", "comment", "blank", "total"
"q:\Projects\Arduino Projects\Mobo\Code\Firmware\Mobo\src\BatterySystem.h", "C++", 60, 0, 20, 80
"q:\Projects\Arduino Projects\Mobo\Code\Firmware\Mobo\src\Component.h", "C++", 22, 0, 7, 29
"q:\Projects\Arduino Projects\Mobo\Code\Firmware\Mobo\src\Config\Config.h", "C++", 0, 0, 3, 3
"q:\Projects\Arduino Projects\Mobo\Code\Firmware\Mobo\src\Driver\MotorDriver.h", "C++", 16, 0, 10, 26
"q:\Projects\Arduino Projects\Mobo\Code\Firmware\Mobo\src\Driver\RN_VNH2.cpp", "C++", 63, 0, 17, 80
"q:\Projects\Arduino Projects\Mobo\Code\Firmware\Mobo\src\Driver\RN_VNH2.h", "C++", 22, 0, 15, 37
"q:\Projects\Arduino Projects\Mobo\Code\Firmware\Mobo\src\Driver\bts7960.cpp", "C++", 60, 0, 15, 75
"q:\Projects\Arduino Projects\Mobo\Code\Firmware\Mobo\src\Driver\bts7960.h", "C++", 25, 0, 9, 34
"q:\Projects\Arduino Projects\Mobo\Code\Firmware\Mobo\src\Helper.cpp", "C++", 1, 0, 6, 7
"q:\Projects\Arduino Projects\Mobo\Code\Firmware\Mobo\src\Helper.h", "C++", 6, 0, 1, 7
"q:\Projects\Arduino Projects\Mobo\Code\Firmware\Mobo\src\Motor.cpp", "C++", 64, 0, 20, 84
"q:\Projects\Arduino Projects\Mobo\Code\Firmware\Mobo\src\Motor.h", "C++", 27, 0, 11, 38
"q:\Projects\Arduino Projects\Mobo\Code\Firmware\Mobo\src\MovementAction.h", "C++", 630, 1, 193, 824
"q:\Projects\Arduino Projects\Mobo\Code\Firmware\Mobo\src\MovementSystem.cpp", "C++", 91, 0, 36, 127
"q:\Projects\Arduino Projects\Mobo\Code\Firmware\Mobo\src\MovementSystem.h", "C++", 28, 0, 13, 41
"q:\Projects\Arduino Projects\Mobo\Code\Firmware\Mobo\src\MowerMotorSystem.cpp", "C++", 52, 0, 14, 66
"q:\Projects\Arduino Projects\Mobo\Code\Firmware\Mobo\src\MowerMotorSystem.h", "C++", 31, 0, 11, 42
"q:\Projects\Arduino Projects\Mobo\Code\Firmware\Mobo\src\ObjectDetectionSystem.h", "C++", 121, 0, 36, 157
"q:\Projects\Arduino Projects\Mobo\Code\Firmware\Mobo\src\Robot.cpp", "C++", 34, 0, 15, 49
"q:\Projects\Arduino Projects\Mobo\Code\Firmware\Mobo\src\Robot.h", "C++", 45, 0, 13, 58
"q:\Projects\Arduino Projects\Mobo\Code\Firmware\Mobo\src\Sensor\AnalogSensor\AnalogSensor.h", "C++", 8, 0, 3, 11
"q:\Projects\Arduino Projects\Mobo\Code\Firmware\Mobo\src\Sensor\AnalogSensor\SimpleAnalogPin.cpp", "C++", 12, 0, 5, 17
"q:\Projects\Arduino Projects\Mobo\Code\Firmware\Mobo\src\Sensor\AnalogSensor\SimpleAnalogPin.h", "C++", 13, 0, 3, 16
"q:\Projects\Arduino Projects\Mobo\Code\Firmware\Mobo\src\Sensor\Boundary\BoundarySensor.h", "C++", 15, 1, 3, 19
"q:\Projects\Arduino Projects\Mobo\Code\Firmware\Mobo\src\Sensor\Boundary\WireSensor.cpp", "C++", 73, 0, 23, 96
"q:\Projects\Arduino Projects\Mobo\Code\Firmware\Mobo\src\Sensor\Boundary\WireSensor.h", "C++", 29, 0, 13, 42
"q:\Projects\Arduino Projects\Mobo\Code\Firmware\Mobo\src\Sensor\Current\CurrentSensor.h", "C++", 10, 0, 4, 14
"q:\Projects\Arduino Projects\Mobo\Code\Firmware\Mobo\src\Sensor\Current\StandardCurrentSensor.cpp", "C++", 20, 0, 5, 25
"q:\Projects\Arduino Projects\Mobo\Code\Firmware\Mobo\src\Sensor\Current\StandardCurrentSensor.h", "C++", 18, 0, 8, 26
"q:\Projects\Arduino Projects\Mobo\Code\Firmware\Mobo\src\Sensor\DigitalSensor\AnalogToDigital.cpp", "C++", 12, 0, 5, 17
"q:\Projects\Arduino Projects\Mobo\Code\Firmware\Mobo\src\Sensor\DigitalSensor\AnalogToDigital.h", "C++", 16, 0, 4, 20
"q:\Projects\Arduino Projects\Mobo\Code\Firmware\Mobo\src\Sensor\DigitalSensor\DigitalPin.cpp", "C++", 11, 0, 5, 16
"q:\Projects\Arduino Projects\Mobo\Code\Firmware\Mobo\src\Sensor\DigitalSensor\DigitalPin.h", "C++", 13, 0, 5, 18
"q:\Projects\Arduino Projects\Mobo\Code\Firmware\Mobo\src\Sensor\DigitalSensor\DigitalSensor.h", "C++", 8, 0, 3, 11
"q:\Projects\Arduino Projects\Mobo\Code\Firmware\Mobo\src\Sensor\Distance\DistanceSensor.h", "C++", 9, 0, 5, 14
"q:\Projects\Arduino Projects\Mobo\Code\Firmware\Mobo\src\Sensor\Distance\HC_SR04.cpp", "C++", 29, 0, 11, 40
"q:\Projects\Arduino Projects\Mobo\Code\Firmware\Mobo\src\Sensor\Distance\HC_SR04.h", "C++", 18, 0, 8, 26
"q:\Projects\Arduino Projects\Mobo\Code\Firmware\Mobo\src\Sensor\IMU\Accelerometer\ADXL345.cpp", "C++", 116, 0, 47, 163
"q:\Projects\Arduino Projects\Mobo\Code\Firmware\Mobo\src\Sensor\IMU\Accelerometer\ADXL345.h", "C++", 89, 0, 15, 104
"q:\Projects\Arduino Projects\Mobo\Code\Firmware\Mobo\src\Sensor\IMU\Accelerometer\Accelerometer.h", "C++", 13, 1, 4, 18
"q:\Projects\Arduino Projects\Mobo\Code\Firmware\Mobo\src\Sensor\IMU\Compass\Compass.h", "C++", 10, 1, 3, 14
"q:\Projects\Arduino Projects\Mobo\Code\Firmware\Mobo\src\Sensor\IMU\Compass\HMC5883L.cpp", "C++", 137, 0, 49, 186
"q:\Projects\Arduino Projects\Mobo\Code\Firmware\Mobo\src\Sensor\IMU\Compass\HMC5883L.h", "C++", 71, 0, 15, 86
"q:\Projects\Arduino Projects\Mobo\Code\Firmware\Mobo\src\Sensor\IMU\GY80.cpp", "C++", 50, 0, 16, 66
"q:\Projects\Arduino Projects\Mobo\Code\Firmware\Mobo\src\Sensor\IMU\GY80.h", "C++", 36, 0, 15, 51
"q:\Projects\Arduino Projects\Mobo\Code\Firmware\Mobo\src\Sensor\IMU\Gyro\Gyro.h", "C++", 11, 0, 8, 19
"q:\Projects\Arduino Projects\Mobo\Code\Firmware\Mobo\src\Sensor\IMU\Gyro\L3G4200D.cpp", "C++", 144, 2, 58, 204
"q:\Projects\Arduino Projects\Mobo\Code\Firmware\Mobo\src\Sensor\IMU\Gyro\L3G4200D.h", "C++", 89, 0, 32, 121
"q:\Projects\Arduino Projects\Mobo\Code\Firmware\Mobo\src\Sensor\IMU\IMU.h", "C++", 14, 0, 8, 22
"q:\Projects\Arduino Projects\Mobo\Code\Firmware\Mobo\src\Sensor\Voltage\StandardVoltageSensor.cpp", "C++", 18, 0, 5, 23
"q:\Projects\Arduino Projects\Mobo\Code\Firmware\Mobo\src\Sensor\Voltage\StandardVoltageSensor.h", "C++", 16, 0, 6, 22
"q:\Projects\Arduino Projects\Mobo\Code\Firmware\Mobo\src\Sensor\Voltage\VoltageSensor.h", "C++", 9, 0, 2, 11
"q:\Projects\Arduino Projects\Mobo\Code\Firmware\Mobo\src\SetupMoboOne.h", "C++", 258, 59, 94, 411
"q:\Projects\Arduino Projects\Mobo\Code\Firmware\Mobo\src\SetupMoboTwo.h", "C++", 1, 0, 0, 1
"q:\Projects\Arduino Projects\Mobo\Code\Firmware\Mobo\src\States\AvoidBackState.h", "C++", 44, 0, 14, 58
"q:\Projects\Arduino Projects\Mobo\Code\Firmware\Mobo\src\States\AvoidTurnState.h", "C++", 83, 3, 32, 118
"q:\Projects\Arduino Projects\Mobo\Code\Firmware\Mobo\src\States\BootingState.h", "C++", 63, 0, 27, 90
"q:\Projects\Arduino Projects\Mobo\Code\Firmware\Mobo\src\States\CruiseState.h", "C++", 44, 0, 16, 60
"q:\Projects\Arduino Projects\Mobo\Code\Firmware\Mobo\src\States\DockingState.h", "C++", 46, 0, 17, 63
"q:\Projects\Arduino Projects\Mobo\Code\Firmware\Mobo\src\States\ErrorState.h", "C++", 24, 0, 11, 35
"q:\Projects\Arduino Projects\Mobo\Code\Firmware\Mobo\src\States\ExitDockState.h", "C++", 41, 0, 16, 57
"q:\Projects\Arduino Projects\Mobo\Code\Firmware\Mobo\src\States\FollowBoundaryState.h", "C++", 33, 0, 12, 45
"q:\Projects\Arduino Projects\Mobo\Code\Firmware\Mobo\src\States\PrepareMowingState.h", "C++", 24, 0, 10, 34
"q:\Projects\Arduino Projects\Mobo\Code\Firmware\Mobo\src\States\SleepState.h", "C++", 23, 0, 11, 34
"q:\Projects\Arduino Projects\Mobo\Code\Firmware\Mobo\src\TaskManager.cpp", "C++", 55, 0, 19, 74
"q:\Projects\Arduino Projects\Mobo\Code\Firmware\Mobo\src\TaskManager.h", "C++", 19, 0, 6, 25
"q:\Projects\Arduino Projects\Mobo\Code\Firmware\Mobo\src\Tasks.h", "C++", 87, 0, 35, 122
"Total", "-", 3380, 68, 1181, 4629